用いる	から が が て て で として として に にかけて のみ は は は は まで も を を を を を を を	従来から 制御技術が 名称が 受けて、 登場している。 白物家電では 手法として 売り文句として 大々的に 1990年代中頃にかけて、 神経ネットワークのみを 白物家電では 1990年代中頃までは、 これは ものではなく、 1990年代中頃までは、 他社も 道具を 記号処理を ルールを 知的制御を 神経ネットワークのみを 行動型システムを 人工知能を
する	か から から から から から から から から から から が が が が が が が が が が が が が が が が が が が が が が が が が が が が が が が が が が が が が が が が が が が が が が が が が が が が が が が が が が が が が が が が が が が が が が が が が が が が が が が が が が が さえ ずつ だけ つつ て て て て て て て て て て て て て て て て て て て て て て て て て て て て て て て て て て て て て て て て て て て て て て て て て て て て て て て て て て て て て で で で で で で で で で で で で で で で で で で で で で で で で で で で で で で で で で で で で で で で で で で で で で で で で で で で と と と と と と と と と と と と と と と と と と と と と と と と と と と と と と と と と と と と と と と と と と と と と と と と と と と と という として として として として として として として として として として として として など など など など など など など に に に に に に に に に に に に に に に に に に に に に に に に に に に に に に に に に に に に に に に に に に に に に に に に に に に に に に に に に に に に に に に に に に に に に に に に に に に に に に に に に に に に に に に に に に に に に において において において において において において にかけて について について について につれて にとって によって によって により により により により により により により に対し に対して の は は は は は は は は は は は は は は は は は は は は は は は は は は は は は は は は は は は は は は は は は は は は は は は は は は は は は は は は は は は は は は は は は は は は は は は は は は は は は は は は は は ば まで まで まで も も も も も も も も も も も も も も も も も より より を を を を を を を を を を を を を を を を を を を を を を を を を を を を を を を を を を を を を を を を を を を を を を を を を を を を を を を を を を を を を を を を を を を を を を を を を を を を を を を を を を を を を を を を を を を を を を を を を を を を を を を を を を を を を を を を を を を を を を を を を を を を を を を を を を を を通して を通して を通じて	つくのでしょうか？」と ここから ことから、 少なさから、 環境から 電子顕微鏡写真から センサーから 携帯電話などから ことから 人権団体などから 2018年5月から、 出されるが、 利用が 「MicrosoftSuphx(SuperPhoenix)」が 身体が ロドニー・ブルックスが、 甘利俊一（日本学士院会員）らが 発生したが、 ブラックボックス性が XMLが 提唱されたが、 試みが セマンティック・ウェブが 規格化が 完了しているが、 ニューロファジィが エキスパートシステムが 知的制御が モデルが 日本が 用いられているが、 ニューラルネットワークが 導入が 名称が 意識されなくなったが、 安定性が 人間が 人工知能が 深層化手法が 環境が 研究が 用語が ワトソンが、 研究チームが 続けているが、 進んでいるが、 開発が ロドニー・ブルックスが 理論が 知が 米DeepMind社が 「AlphaGo」が 手法が DeepMindが、 データが ディープラーニングが 理論が ビッグデータが 研究開発競争が ITインフラが 環境が インターネットが 事が カプセルネットワークが OpenAIが Googleが 中国が 中国勢が 中華人民共和国が 中国が スマート街灯が 中国が 人権侵害が ことが EU一般データ保護規則が 研究チームが OODAループが 中国が Googleが ことが Microsoftが 中国が ことが 倫理委員会が レバンドウスキーが 哲学者ジョン・サールが （科学哲学）が、 アナログが 「ノイズ」が 多くが 本が、 書店販売されていたが、 高かったが、 問題が 概念さえ 「ボットひとつずつ、 構築しているだけでなく、 握りつつあると 用いて 解析して 超えて なされている。 行われている。 でて 始まっていると 完了しているが、 解釈して 学習して 分かっている。 用いられているが、 基づいて、 突破して 用いられており、 実証されている。 続けているが、 用いて 用いている。 勝利して以降は 付けて リバースエンジニアリングして 立ち上げられている。 されている。 寄せており、 行って 展開されている。 経て 投じられてもいる。 されている。 主張している。 なっている。 於いて、 行われている。 予防拘禁していると なっている。 輸出しており、 稼働させて 更新して 行っている。 進展しており、 協力していると 面談して 開放されていると 拡散させて 構築しているだけでなく、 含まれており、 表現されており、 関連付けて 関連して、 残してこなかった」と 批判している。 語ろうとしてきた。 信用していなかった。 理解していない。 述べており、 基づいている」と 批判している。 書店販売されていたが、 起こっており、 述べており、 コンピュータ上で ダートマス会議で ACT-Rでは、 最近では、 各分野で 日本では 機構で 巻き込んで センサーで 学会で 製品名では 運転モードでは 数式で 現在では 点で 著作で、 英国エコノミスト誌で 練習戦で 上で 中で 進んでいるが、 現場では、 中国では 官民一体で 日本で 大会でも 5年で 開発競争で 政治目的で 人工知能で 人工知能で 人工知能で 人種プロファイリングで 新疆ウイグル自治区では 香港では、 人工知能で 欧州連合では 模擬空戦で ブエノスアイレスで 自律飛行実験で 統合運用）で 設立などで アメリカでは 中東で AIで 倫理面で 哲学者・政策立案者・経済学者・テクノロジスト等で 理由で、 神経膜では デジタルで 神学でも 研究分野」とも 主体と 基本と ソフトコンピューティングと 始まっていると 機械であると 専門と 現代制御等と 訪れる」と 挑んだと 有望と 必要だと よると、 寄与できると 入ると 困難と アレン脳科学研究所と 欧米と あると 占めてるとも 握りつつあると 支出すると 予防拘禁していると 次々と 繋がると あると 勝利したと 必要と 加速すると 協力していると トランプ大統領と 開放されていると 関わったと モデリング」と 実用化してると 設置すると 神と こと」と 征服するんだ」と よると、 実現できないと 科学と 残してこなかった」と 過ぎない、と 語ろうとしてきた。 考えだと シンギュラリティと 基づいている」と よると、 よると、 確かでしょう」と つくのでしょうか？」と ファジィ制御という AIとして 方法として、 用語として 分野として 分類としては 技術として、 （ファジィルールとして ロボット向けとしては、 結果として、 嚆矢として、 あるとして 力として、 Wikipediaなどを 富士通などを 携帯電話などから 人権団体などから 選別攻撃などに 行うなど 設立などで 1956年に 計算機に 機械的に 社会に 十段に 元に 「神経活動に 1943年に 自律的に 時代に 知能には 世界チャンピオンに 1992年に 精力的に 明らかにした。 1998年には 同年に、 データに 国際的に 2000年代前半に 後に フレーム問題に 高速に 盛んに 元に 2018年までに 利用者には 2010年に 柔軟に 高級路線にも 応用にも 客観的に 一般には 十分に 2003年頃には、 分野に 2006年に、 2010年に 同年に 人間に 2013年には 2014年には、 ように 2015年10月に プロ囲碁棋士に 2017年8月には、 2012年に （人工意識）に 急速に 急速に 機械に 2017年10月には 2022年までに 中国に ロボットに 新疆ウイグル再教育キャンプに 市民に 世界各国に 世界に 社会信用システムに 境界線には P-1(哨戒機)のように 戦闘指揮システムに 支援用に 一方的に 2017年には ものに 2015年に 選別攻撃などに 核開発に 2017年6月に 前年2016年に 飛行実験に 翌2018年5月には 6月には 急速に 中国人民解放軍に 人々に 軍事利用に 社員に 同様に 中国政府に 大量に 自律的に ために AIに ことに 抽象的に 実際には （コンピュータ科学）・人工知能研究開発等に クリックに 頃に 具体的に 宇宙において、 提案書において、 湾岸戦争において 日本においては 開発において 観点において、 2017年にかけて、 ことについて （不動点定理）について、 天文学について 進むにつれて Web開発者にとっては AIによって 専門誌によって ジョン・マッカーシーにより ティム・バーナーズ＝リーにより、 研究チームにより 齊藤元章により、 高性能化により、 ブレイン・マシン・インターフェースにより、 軍事利用により 元CEO（トラビス゠カラニック）に対し 非構造化データに対して、 P-1(哨戒機)のように 実現は、 ACT-Rでは、 最近では、 ブレーズ・パスカルは 彼はまた アラン・チューリングは ジョン・マッカーシーは ジョセフ・ワイゼンバウムはを アラン・カルメラウアーは テッド・ショートリッフェは 知能には IBMは 国防高等研究計画局は、 日本では 1998年には Web開発者にとっては 普及は 日本においては ブームは 利用者には 製品名では 分類としては 運転モードでは ブーム後は 一般には 現在では 2003年頃には、 レイ・カーツワイルは 2013年には 2014年には、 （UCAVは ロボット向けとしては、 ロボットは、 勝利して以降は 2017年8月には、 現場では、 2017年10月には MITリンカーン研究所は Googleは 中国では フランス大統領エマニュエル・マクロンは 韓国は、 『人工知能は 新疆ウイグル自治区では 香港では、 際は 中国は 欧州連合では イスラエル軍は 境界線には 「ALPHA」は、 AIプログラムは 処理能力は アメリカ合衆国国防総省は、 2017年には 不安定化は 首脳らは、 翌2018年5月には 6月には 中国は 成果は アメリカでは 人権侵害は 際は 中国は Googleは Google社員らは Googleは 使命は 海外メディアは 我々は 哲学者は 思考実験は、 実際には フランシス・クリックは 理論物理学者ディラックは、 哲学者たちは 神経膜では トルケル゠フランセーンは、 本は 須藤は、 須藤は よれば、 2018年までに これまで 2022年までに 研究分野」とも 成果も 現在も 従来よりも 高級路線にも 応用にも 概念も 投じられてもいる。 齊藤元章も 占めてるとも 大会でも 連携も 国際標準化も 映像も 主張も ドローン兵器も 神学でも 当時より 従来よりも 『知能』を 知的能力を 推論・判断を 画像データを パターンを 記述を カウンセラーを 役割を 知性を ディープラーニングを ことを これらを 推論ルールを、 統計的学習を 機械式計算機を 『数学原理』を 論文を プログラミング言語を テストを 「チューリングテスト」を ジョセフ・ワイゼンバウムはを 『パーセプトロン』を プログラミング言語を ルールベースシステムを コースを 乗り物を （身体性）を バックギャモン専用コンピュータ・TDギャモンを ユニットを ことを 意味付けを 意味を 方法を オントロジーを 在り方を エキスパートシステムを 命令を 問題を 特徴を 2つを 運転を 特許を 研究を 運転を チューニングを ニューロファジィ制御を 限界を 製品を 対象を 制御を 知的制御を 表現する）を 人間を 世界を 説を 問題を 理論を 「ディファレンシャブル・ニューラル・コンピューター」を 「ワンショット学習」を 記号接地問題(シンボルグラウンディング問題)を （AGI）を 脳を 身体知を 脳を ブレイン・マシン・インターフェースを ことを AIを 好奇心を 推論を アーキテクチャを Wikipediaなどを データを ソフトウェアを 神経回路を 研究開発を 実験を 研究開発を 可能性を 上位を （約1600億円）を 富士通などを 投資を AI機関を 深層学習を 可能性を 人工知能を 人権を 感情を （天網）を 個人情報を 監視カメラを AI監視技術を ビッグデータを 格差を 研究を 「ファランクスCIWS」を 「アイアンドーム」を 標的を サムソンRCWSを 人間を 戦争を ファジィ制御を これを 国際ルールを 記録を 都市を Googleを 共同研究を 監視国家を 無人攻撃機を 個人を 人工知能プロジェクトを AI倫理委員会を 反科学・反マイノリティ・地球温暖化懐疑論等を 解任を 解散を 東洋哲学を AIを 道)」を 実現を 社会を 機密情報を 世界を 話を ことを 問題を 哲学者を 状況を 勘違いを 問題を 言葉を 生成規則を通して 崇拝を通して （ITU）を通じて
指す	を	一分野」を
代わる	に を	人間に 知的行動を
行う	から が が が て て て て て で で で で など に に に に に に に に に に は は は は は は は まで まで を を を を を を を を を を を を を を を を を を を をめぐって	地上から 研究が 監視社会・管理社会化が 公式専門家会議が 代わって 出しており、 付加して、 意識されなくなっている。 始めており、 民間企業主導で 無報酬で 中国では 国際連合で 搭載するなど コンピューターに 元に 盛んに 1956年に Webに コンピュータに 1990年代には 全世界的に 人工知能に 2017年11月には エイダ・ラブレスは 1990年代には 概念は 産業応用は 中国では 2017年11月には 米国・中国・ロシアは 歩行者まで 「これまで 経験を 学習を コンテンツ生成を 開発を 来談者中心療法を 処理を 知的処理を 知的処理を 投資を 探索を 研究を 脳シミュレーションを 監視を 開発競争を 試験を 「メイヴン計画」を 裁判を 意思疎通を 議論を 軍事利用をめぐって
述べる	かも て て て て て て で で で と と と と と と と に に に に の の は は は は は は は は は も	大きいのかもしれません」と 不明瞭になってきています。」と 不明瞭になってきています。」と 評価されている。 返している。 取り上げて、 している。 解説で、 専門家ではない」と 一方で、 変わると 不明瞭になってきています。」と 思う」と 専門家ではない」と 扱わない」と 不可能です」と 大きいのかもしれません」と 次のように 不明瞭になってきています。」と 研究するようになった。 次のようにも 次のように 次のようにも 佐藤理史は 釈徹宗は 澤口俊之は、 田中一之は 専門家ではない」と これは 伊勢田哲治は、 須藤は 伊勢田は、 次のようにも
ある	か が が が が が が が が が が が が が が が が て て て て て て て て で で で で でも として として に に に に に に に において に対して は は は は は は は は は は は は は も も も も も も も	何か 画像認識等が 知られているが、 ものが ものが 必要が 利点が 限界が 進展が 可能性が 懸念が バイアスが 可能性が 必要が 文化が 「その通りですが、 問題が 使われている。 困難視されている。 知られているが、 関係している。 比較して、 考えて、 比較して 射殺している。 中国では 6割で アメリカ側では アニミズムで、 幹部でも 手法としては、 与えられたとしても、 記号的明示性に 場合には 向上には 関係に 環境に 状態に それ自体に 言語処理において 達したのに対して 応用例は (GoodOldFashionedAI)との差は 手法としては、 これは、 場合には 手法は、 作業は ニューロファジィは 向上には 中国では Amazonは AIは アメリカ側では ことも 手法も ことも 問題も 与えられたとしても、 主張も ことも
使う	が で でも に に に によって のみ は は は も を を を を を	Pythonが 現在では、 意味あいでも 1980年代に、 スケジューリングするのに 社会インフラにも バックプロパゲーションアルゴリズムによって 家電製品のみならず、 現在では、 ニューラルネットワークは プログラミング言語は 社会インフラにも AIを 専用プログラムを AIを 自律無人艇を 日常的言語を
呼ぶ	て と と と と と と と と など に は は も も を を	鳴らしており、 「エキスパートシステム」と 機械学習と エキスパートシステムと ゲンギスと ディープラーニングと 一人と 「AI独裁」と スウォームと メディアなどは 同様に 人工知能は メディアなどは 思考ルーチンも 際も 政治体制を 波紋を
出す	が が で で に に により は を を	（人工無脳）が 公開書簡が 第3次人工知能ブームでは、 人工知能国際合同会議で、 引き合いに 2012年に 企業家らにより 第3次人工知能ブームでは、 精度を 開発禁止令を
持つ	から が が が が が に を を を を を を	1985年頃から 人間が 松下電器が 人間が 対象が 「哲学者が 暗黙に 機構を 「脳」を 深層学習システムを、 認識能力を 現実味を 興味を
なる	から から が が が が が が が が が が て て て て て で で で で で で と と と と と と と と と と と として など に に に に に に に に に に に に に に にとって は は は は は は は は は は は は は は は は も も	事から、 2013年から 記述が 試みられてきているが、 解決が ニューロファジィが 特徴が 白物家電が 中国が 数学知識が マサチューセッツ工科大学が 開発競争が 試みられてきているが、 試みられてきているが、 超えて 報じられており、 されている。 麻雀では 日本で 世界中で 論文数では 精度で おかげで、 問題と 最先端技術と 壁と ブームと 利用可能と ニュースと 計算資源と 世界一と 必要と Amazonと ものとは ないとして 到達するなど、 1950年代に ものに ブームに 1990年代末には 大多数に 2017年には 話題に 行うには 国際問題に 論争に ことに 数年以内に 事態に 愚痴に 人類にとって 麻雀では 場合は 1990年代末には 2017年には 論文数では 行うには 人権侵害は Megviiは 際は 変化は 一部は ものとは ドナルド・トランプ大統領は CEOサンダー・ピチャイは 「これは 違いは 知識も 線引きも
知る	として は も	アプローチとしては、 アプローチとしては、 アプローチも
集める	から が に は を を を を	ことから、 「サポートベクターマシン」が 急速に ファジィは 注目を 注目を 注目を 天才児を
超える	における を を を を	議論における 流行を 米国を 人間を 脳を
行く	て により	浸透して 登場により、
破る	が も	AIが プレイヤーも
繰り返す	を	学習を
基づく	に に に に に に	経験に 知識工学に データに これに （AI）に 自由連想に
作る	も を	褒賞制度も 知的システムを
なす	も	試みも
上回る	が で で を を を	コストが 領域で 読解テストで 人工知能を 投資全額を 人間を
でる	が と	派生が GANと
だす	が で を	ディープラーニングが 分野で 成果を
加える	に	ことに
見せる	て て において は を を	活躍している。 加えて、 生成技術において （敵対的生成ネットワーク）は、 進化を 振る舞いを
広がる	が に は	応用分野が 背景に、 森正弥は
始まる	から が て て は も	（スコレー）から 第三次AIブームが 見せている。 広がっており、 哲学は 応用も
試みる	が は を	構築が 軍隊は、 自動化を
もたらす	に は を	形式論理に アルフレッド・ノース・ホワイトヘッドは 革命を
題する	と	論理計算」と
築く	は を	ウォルター・ピッツは 基礎を
出る	が と に関して	成果が なると AIに関して
作り出す	で を	会議で 用語を
示す	が が て て で で に に は は は は は を を を を	ことが、 ゲーデルが 出版して 創立している。 プログラム中で 観察結果で 間に、 1931年に ジョエル・モーゼスは シーモア・パパートは アンソニー゠レバンドウスキーは Waymoは、 レバンドウスキーは パワーを 限界を パワーを 振る舞いを
上げる	が で として は も も を を	アプリケーションが 分野で 脳研究プロジェクトとしても 1990年代は ことも 脳研究プロジェクトとしても 成果を 成果を
打つ	に を	1997年5月に ガルリ・カスパロフを
敗れる	が で に に は は	村上健が オセロで 8月には オセロ専用コンピュータ・ロジステロに チェス専用コンピュータ・ディープ・ブルーは、 8月には
省く	によって	これによって
適す	に	アプリケーション別に
含む	に に は は も も を	規格には 倫理委員会には 規格には 倫理委員会には OWLも 人物も 要素を
分かる	か から が が が に について は	識別したのかが ことから、 ことが ことが 識別したのかが 明確に ファジィについては、 ファジィについては、
見合う	に	開発工数に
見出せる	が	メリットが
進む	から から が が として に において は	能力限界から ディープラーニングから 研究が 研究開発が 遅々として 軍事・民間共に 世界各国において、 改善は
至る	に に に は は まで も	AIに 実現には 上回るに 日本は 実現には 1992年まで 進めるも、
入る	が で に に に に に に は まで	計算リソースが コストで 1980年代に 2010年代に 手に 2019年に 2022年までに 世界トップ4に 目標は 2022年までに
立ち上がる	て と に に も	入って、 次々と 中心に、 提案されるようになり、 AIベンチャーも
生まれる	から によって	流行から 脳スキャンによって
挙げる	が が として は を	第五世代コンピュータが 懸念が プロジェクトとして 井口尊仁は プロジェクトを
費やす	として を	国家プロジェクトとして 570億円を
進める	が て について も を	研究が 費やして 影響についても 影響についても 研究を
異なる	が で も	解釈が 専門家間で 哲学も
行える	が	ルール化が
見つかる	が が で	Prolog専用機であるが、 応用先が 意味で
迎える	が で に を を	手法が 程度で 中心に ブームを 限界を
合わせる	に	高級路線に
増やす	て で に も を	合わせて、 白物家電製品でも 大幅に 白物家電製品でも 種類を
巻き込む	も	一般人も
言える	と と も	前史とも 社会現象と 前史とも
活かす	に を	制御に 曖昧さを
漕ぎ着ける	に	発売に
関わる	が に に に に に も も も も	AI研究者が 制御技術であるにも 努力にも 持たないにも 高速化にも 標的選択支援アルゴリズムに 制御技術であるにも 努力にも 持たないにも 高速化にも
選ぶ	が で	「ファジィ」が 金賞で
巻き起こす	だけ て に は を	評価されるだけでなく、 成功して その後に、 松下電器は ブームを
受ける	て で で と とともに は を を を を	暴露されており、 公聴会では、 整合性で 拒否すると 「」とともに、 公聴会では、 成功を 普及を 動向を 追及を
売る	の	白物家電の
抑える	を	開発工数を
できる	が が て て て で ながら に に に によって により により は は も を を を	意識が 言明自体が 含めて 試みている。 使っても、 事で 抑えながら、 リアルタイムに 社会変革に 「期待どおりに 形式論理システムによって ジェフリー・ヒントンにより ガトリング砲により アメリカ海軍は ことは 使っても、 柔軟性を 組み合わせ最適化問題を 対艦ミサイルを
与える	が が など に に に は を	データが 人工知能が 雇用などに 潤沢に 雇用などに 政界に 軍用AI開発は 危機感を
無くなる	は	進展は
去る	は	ブームは
担う	を	進歩を
訪れる	が に も	（シンギュラリティ）が 2045年にも 2045年にも
扱う	し で で に の のみ は も を を を を を を	扱わなくなりましたし、 天文学では 物理学でも 哲学的・統一的に 学問の タスクのみを 天文学では 物理学でも データを タスクのみを タスクを 「大きな」問題を 〔哲学的〕問題を 問題を
果たす	が で に を	チームが 画像処理コンテストで 2012年に 精度改善を
挑む	で に に	「東ロボくん」で 模擬試験に 作成に
臨む	が に	受験生が 実際に
先立つ	に	特異点に
近づく	が により	生産コストが 進歩により
向ける	に に に	実現に 実用化に 開発支援に
続ける	が て を	ジェフ・ホーキンスが、 向けて 研究を
留まる	に	ものに
導き出す	を を	関連性を ものを
付ける	で に を	画像処理コンテストで 手法に 圧倒的大差を
受け止める	て は	持って 概念は
立つ	が て に に に において は を	プロジェクトが 受けて、 受け止められるようになった。 筆頭に、 ために、 現場においては、 現場においては、 ニューラ・リンク社を
組み合わせる	を	機械学習を
動かす	で を	仮想空間で モデルを
学ぶ	に を	高速に ことを
考える	かも て と と と は	起こり得るかもしれない。 示されている。 不可能と よると、 「極めて困難」と 脳は
思う	が と と と という に は は	なるが、 あると 『暇』だと 明らかになったとは 思想家というのは 明らかになったとは 思想家というのは 明らかになったとは
いる	が て について は も も	否定しているが、 否定しているが、 危険性について、 松尾豊は、 研究者も 著名人も
寄せる	が に を	企業が 活用に 関心を
目立つ	から が て で で も	2016年頃から、 報道が 整備され始めている。 形で、 ニュース番組でも ニュース番組でも
取る	が が に対して を	イーロン・マスクが、 人間が 人工知能に対して 遅れを
含める	まで を	位置関係まで ウィトゲンシュタインを
よる	か など に に に に に に に に に に に や	ことか』に 教授やなどに 提言に 教授やなどに 米国政府に 日経新聞調べに 内田樹に ダニエル・デネットに 創られる』に 前掲書に 田中に フランセーンに ことか』に 教授やなどに
いう	て て て と と と と ば	達していると 述べている。 している。」と 人間らしいと 達していると 入ることだと している。」と よれば、
経る	を を を	段階を ウイグル族を 法的手続きを
達す	て で で に に は は	開発している。 時点で、 9割超で 1Zettaバイトに 8割に データ量は IBMは
始める	とも は を	マックスプランク研究所とも Googleは、 共同研究を
位置づける	から に を	第13次5カ年計画から 国家プロジェクトに AIを
投じる	が て で と に は	215億ユーロが 集めて 教育機関では 公然と 開発に 教育機関では
占める	が は	中国が 3は
握る	が で を	中国が AIで 覇権を
著す	を	『』を
取り上げる	が て て など は ば を	メディアなどが 独占している。 著して メディアなどが 台湾系アメリカ人科学者のは よれば、 言葉を
開く	に を	パリに AI研究所を
於く	か に	超えるか』内に 超えるか』内に
起こす	に対して を	人間に対して 反乱を
鳴らす	て に に に は は を を を	呼ばれているは ことに 2019年11月に ことに 呼ばれているは マーク・エスパー国防長官は 警鐘を 警鐘を 警鐘を
併せ持つ	を	弾圧を
変わる	が は	既成概念が 教授は
埋め込む	に	帽子に
推し進める	が	プロジェクトが
犯す	で に も を	2017年6月時点で 経ずに 約1万5千人も 犯罪を
報じる	が	内部文書であるが
送る	が に を	コンピュータが 強制収容所に 人間を
恐れる	を	監視社会化を
起きる	が	2019年香港民主化デモが
決める	て を を	活用して 適性を 軍事バランスを
繋がる	に は	ことに 制度は、
認める	を	差別を
生む	を	軍事能力を
変える	を	展開を
介す	から を	観点から 判断を
勝ち残る	が に	人間が 人工知能に
操る	たり により を を	なりすましたり、 ボット投稿により 銃火器を 世論を
続く	に	核兵器に
とらえる	と	革命と
記す	て で と と は は	定義できていない」と 話ではない。 ならないと 定義できていない」と 話ではない。 前掲書は
求める	が に は を	ヒューマン・ライツ・ウォッチが、 4月には 4月には 禁止を
めぐる	を	運用を
盛り込む	て に は は も	求めている。 2019年8月に 同会議は 法的拘束力は 採択するも
評す	と も	あるとも あるとも
追い付く	に	アメリカに
備える	に	将来に
限る	に	中国に
誓う	が	Googleが
なりすます	たり で	攻撃したり ディープフェイクで
応じる	に	テーマに
見いだす	に を	ものに 霊的存在を
語る	て で と に は を を を	応じて、 日常的言語で あります」と 三宅および立石従寛に 哲学者は、 『科学を 「宇宙」を 『科学を
やる	て に を	やって AIに 悟りを
論じる	か が て で に を	やらせるか」を 哲学が 伴って 一部で 哲学的に やらせるか」を
通じる	に は も	哲学塾東洋哲学篇』にも アニミズム的人工知能論は 哲学塾東洋哲学篇』にも
関連付ける	と など	歴史などと 歴史などと
訴える	を	ことを
言う	か が て て て で と と と において は は は は	ことか』において 発明家レイ・カーツワイルが 指摘している。 述べている。 伝えており、 的外れではないと、 的外れではないと、 特異点と 進歩」だと ことか』において 須藤靖は、 的外れではないと、 野家啓一は 須藤は
残す	は も を	「哲学者たちは 何も 成果を
過ぎる	に は	学問・科学に 哲学は
まじる	の	私の
伝える	が と	アリストテレスが 始まったと
違う	が と と は は	定義が 科学とは 物理学者とは 科学とは 物理学者とは
見る	から が て など に は も	観点から ディラックが 説明していた。 入門書などにも 入門書などにも 間違いは 入門書などにも
創る	は	『人工知能は
伴う	に	発展に
捉える	として を	「デジタル情報処理システム」として 脳を
起こる	て に に は は ば	記している。 確かに、 一般に シンギュラリティは 誤解・誤用は 見れば、
生み出す	が によって	「カオス」が アナログ量によって
書く	が について	哲学者が 不完全性定理について
返す	か と に対し は	あるのでしょうか」と あるのでしょうか」と 伊勢田に対し、 須藤は
しれる	という は	違いというのは 違いというのは
つく	か が が て は	何か 思いますが、 決着が 行ってきました。 「決着は
答える	で と ね は	対談で つかないでしょうね」と つかないでしょうね」と 伊勢田は
